R 200 200
NO ./textures/north.xpm            
WE         ./textures/west.xpm        
SO                ./textures/south.xpm           
EA    ./textures/east.xpm      
S ./textures/sprite.xpm      
F  120 , 20,  30
C 120, 32, 2



11111111111
10001110001  111
10000000001  101
1000000000111101  
100222222200001111111111 
1200010000000001 
100000000011111   
1000000000001
100000000011
 10S02220001
111111111111

11111
100111
1