           R 20000000 2000000
NO  ./textures/north.xpm 
SO ./textures/south.xpm     
WE   ./textures/west.xpm
S ./textures/sprite.xpm
F  0, 255,  0
EA                       ./textures/east.xpm                          
C 255, 0, 0


111 1111111111
12W1
10021  111 11 1 
1111
11



