R  1880  000000000010000000001
SO       ./textures/south.xpm 
NO  ./textures/north.xpm
EA ./textures/east.xpm
WE ./textures/west.xpm  
S ./textures/sprite.xpm
C 255, 255, 255
F 0, 0, 1

11111111111                                  1
10001112001111111                            1
1110000000200111111111111111111111111111111111111111111111111111111111111111111111111111111111111111111111111111111111111
10000E00000000000000000000000000000000000000000000000000000000000000000000000000000000000000000000000000000000000000000021
1000000201111011111111111111111111111111111111111111111111111111111111111111111111111111111111111111111111111111111111111
1000011221000001111111111
1000000000000001111111
1000000200111111
11000102001 11111         1111111
100001121111000001111111111 11111 11       111111
11110002010020100000000011111101111111111
1221000201100101110000000000000022222221
111211021000000001111111111111111111111
11111111111111111111111111111111111111111111111111111
