R 100 100
NO    ./textures/north.xpm           
WE         ./textures/west.xpm        
SO                ./textures/south.xpm           
EA ./textures/east.xpm      
S  ./textures/sprite.xpm               




F  20 , 0,  ,  100
C 10,0,           190


11111111111
10001110001  111
10000000001  101
10000000001  101
100000000011110111111 
12000N0000000001
100000000011111
1000000000001
100000000011
10002220001
11111111111

111
101
111


