R 800 600

NO ./textures/north.xpm
SO ./textures/west.xpm
WE ./textures/south.xpm
EA ./textures/east.xpm
S ./textures/sprite.xpm
F 99, 34,93
C 10, 74,4


11111111111111111111111111111111111111111111
10002000222222222222200000000000000002000011111111
100020000000000000000000000000000000020000111111111
10002000000000001111111100000001102000011111   1         1
1011111111111111111120000000000100000200111111
1000200100000000000000110000001000000020000111111
100011201000000000010000000000000110001100000200001111111111
1000200001000000000011111000000000020000111111111111111
10002000001111111110000000000011002000101111111111111111
100020000000000000000000110100000001100200001111111
100020000000000000000110000011000110000000020000111111111
100N0000200020000001110002001100000000000000001111111111
100020000002000000000020000111100000020111111111
1000200000002200000200000000020002002002000111111111
111111111111111111111111111111111111111111111
