R            600          600

NO           ./textures/north.xpm
SO              ./textures/west.xpm
WE                                         ./textures/south.xpm
EA     ./textures/east.xpm
S      ./textures/sprite.xpm
F 130,135,                                    41
C    12  ,        12,     12


111111
10000111 11
100000211221111111111111111111111111
100022000001000000000000000000000001
10000W011000001111111111112221121101
100000001111111     1111  111  1 101
1000000001                       101
100000011                        101
10020001                         101
10020001                         121
11111111                         111

111
1N01
111
