 R 500 500
    NO         ./textures/north.xpm      
    SO ./textures/south.xpm            
 WE                ./textures/west.xpm            
    S ./textures/sprite.xpm      
 F  0, 0,  0
      C 0, 0, 0
  EA    ./textures/east.xpm      


111
11
11111  111111 1111
10001110001  111
10000000001  101
1000000000111101                       
10000111111000001111111111
1200010000100001
1000000000111111
110001000011111111
100001111111000001111111111
11110000010000100000000011111111111111111
1221000001100101110000000000000022222221
111211000S000000001111111111111111111111
11111111111111111111111111111111111111111111111111111



111000
1
