R   500    1000          

SO ./textures/south.xpm

NO                     ./textures/north.xpm
EA ./textures/east.xpm
S ./textures/sprite.xpm
WE ./textures/west.xpm  
C 80, 112, 1

F 0,0,0








11111111111                                  1
10001112001111111                            1
11100000002001111111111111111                 111
10000N0200111111011
10000002011110111
1000011221000001111111111
120010200100001
1000000200111111
11000102001 11111         1111111
100001121111000001111111111 11111 11       111111
11110002010020100000000011111101111111111
1221000201100101110000000000000022222221
111211021000000001111111111111111111111
11111111111111111111111111111111111111111111111111111
