R            600          600

NO           ./textures/north.xpm
SO              ./textures/west.xpm
WE                                         ./textures/south.xpm
EA     ./textures/east.xpm
S      ./textures/sprite.xpm
F 130,135,                                    41
C    12  ,        12,     12


11111111111
10001110001  111
10000000001  101
10000000001  101
1000000000111101
12000N0000000001
100000000011111
10000000001
10000000001
10002220001
11111111111

111
101
111

