     R 500 500
    NO         ./textures/north.xpm      
    SO ./textures/south.xpm            
WE   ./textures/west.xpm    
    S ./textures/sprite.xpm     

 F  0, 80,  0
  EA    ./textures/east.xpm      
                                            C 0, 0, 50


111
11
11111  111111 11111
11111111111111
1111111111111111111111111
10S01110001  111
10001 11111111111
10200100001  101
1020000000111101                       
10200111111000001111111111
1200010000100001
1000000000111111
110001000011111111
100001111111000001111111111
11110000010000100000000011111111111111111
1221000001100101110000000000000022222221
1111111111111111111111111111111111111111
11111111
10001200111
1100102001011
10001111111111
100111
101111
11111