R 50 50 



NO ./textures/north.xpm            

WE         ./textures/west.xpm        

SO                ./textures/south.xpm           

EA    ./textures/east.xpm      

S ./textures/sprite.xpm      


F  120 , 20,  30

C 120, 32, 2


11111111111
10001110001  111
10000000001  101
1000000000111101  
100222222200001111111111 
1200010000000001 
100000000011111   
10000000000011111111111111111111111111111111111111111111111111111111111111111111111111111111111111111111111111111111111111111111111111111111111111
100000000000000000000000000000000000000000000000000000000000000000000000000000000000000000000000000000000000000000000000000000000000000000000111
 10E000000000000000000000000000000222222222220000000000000000000000000000000000000000000000000000000000000000000000000000000000000000000000000011
111111111111111111111111111111111111111111111111111111111111111111111111111111111111111111111111111111111111111111111111111111111111111111111111


