R 10000 8000
SO ./textures/jungle-1.xpm 
NO ./textures/jungle-2.xpm
EA ./textures/jungle-3.xpm
WE ./textures/jungle-4.xpm
S ./textures/banana.xpm
C 31,14,28    
F 100, 125, 52

11111111111
10001112001111111
111000000020011111111111111111111111111111111111111111111111111111111111111111111111111111111111111111111111111111111111
10000010000E0000000000000000000000000000000000000000000000000000000000000000000000000000000000000000000000000000000000021
100000020111101111111111111111111111111111111111111111111111111111111111111111111111111111111111111111111111111111111111
1000011221000001111111111
1000000000000001111111
1000000200111111
11000102001 11111         1111111
100001121111000001111111111 11111 11       111111
11110002010020100000000011111101111111111
1221000201100101110000000000000022222221
111211021000000001111111111111111111111
11111111111111111111111111111111111111111111111111111
